.
.
.
.
.
.
.
.
................................................................................^
............................^.............^.....................................#
............................#.............#.....................................#
.^.......####^^^^^^^........#.............#............^.....^.....^.....^......#

.
.
.
.
.
.
.
.
.
............................^.............^
.................###........#.............#
.^.......####^^^^###........#.............#............^.....^.....^.....^

.
.
.
.
.
.
.
.
.
...................................^............^
.................###...............#............#
.^.......####^^^^###...............#............#......^.....^.....^.....^

.
.
.
.
.
.
.
.
................................................................................^
...................................^............^...............................#
...................................#............#...............................#
.^.......####^^^^^^^...............#............#......^.....^.....^.....^......#

