.......................................................................................................................................................................................................................................$
.......................................................................................................................................................................................................................................$
.......................................................................................................................................................................................................................................$
.......................................................................................................................................................................................................................................$
.......................................................................................................................................................................................................................................$
.
.......................................................................................................................................................................................................................................#
.......................................................................................................................................................................................................................................#
..............................^...........................................^.............................................^^^^^^^^^^^^^^^^^^^^^^^^^^^^^^......^...........................^................^...........^.................#
...........................####......................^....................$.............................................##############################......#########...................%................$...........#.................#
......................$$$$$####......................%.................$$$$#####.......................$$...............##############################......#########...................%................$...........#.................#
.^.....^.....^....%%%%$$$$$####...........^..........%..............$$$........#^^^^^^^^^^^^^^^^^^^^^^^$$^^^^^^.........##############################......#########.............^.....%................$...........#

.......................................................................................................................................................................................................................................$
.
.
.
.......................................................................................................................................................................................................................................$
.
.......................................................................................................................................................................................................................................#
.
............................................................................................................................................................^...........................^.........^......^
...........................####......................^......................................................................................................#########...................%.........%......$
......................$$$$$...#......................%.................$$$$#####....%%%%%%.....$$..$$..$$.................##..$$$$$$$$$$................................................%.........%....................................#
.^.....^.....^....%%%%........#...........^..........%..............$$$........#^^^^^^^^^^^^^^^$$^^$$^^$$^^^^^^...........##^^$$$$$$$$$$^^^^^^^^^^^^^^............................^.....%.........%..................^

.......................................................................................................................................................................................................................................$
.
.......................................................................................................................................................................................................................................$
.
.......................................................................................................................................................................................................................................$
.
.......................................................................................................................................................................................................................................#
.
............................................................................................................................................................^...........................^.........^......^.............................#
...........................####..................^.......^..................................................................................................#########...................%.........%......$
......................$$$$$...#..................%.......%.............$$$$#####%%%%%....%..%%%$$..$$......$$.............##..$$..........$$$$$$$$$$....................................%.........%....................................#
.^.....^.....^....%%%%........#...........^......%.......%..........$$$........#^^^^^^^^^^^^^^^$$^^$$^^^^^^$$^^...........##^^$$^^^^^^^^^^$$$$$$$$$$^^............................^.....%.........%..................^

.......................................................................................................................................................................................................................................$
.
.......................................................................................................................................................................................................................................$
.......................................................................................................................................................................................................................................$
.......................................................................................................................................................................................................................................$
.
.......................................................................................................................................................................................................................................#
.
..............................^...........................................^.............................................^^^^^^^^^^^^^^^^^^^^^^^^^^^^^^......^.....................................^......^...........^.................#
...........................####..................^.......^................$.............................................##############################......#########.............................%......$...........#.................#
......................$$$$$####..................%.......%.............$$$$#####.........%%%%..............$$...........##############################......#########.............................%......$...........#.................#
.^.....^.....^....%%%%$$$$$####...........^......%.......%..........$$$........#^^^^^^^^^^^^^^^^^^^^^^^^^^^$$^^.........##############################......#########.............^...............%......$...........#

